#Wa Nations
KNU = "countries/Kenu.txt"
KOS = "countries/Koshi.txt"
OWR = "countries/Owari.txt"
YMT = "countries/Yamatai.txt"
IZM = "countries/Izumo.txt"
KIB = "countries/Kibi.txt"
TKS = "countries/Tsukushi.txt"
KUD = "countries/Kudara.txt"

#Greater China Nations
THW = "countries/Hwan.txt"
MNE = "countries/Mien.txt"
GAN = "countries/Gan.txt"
SNG = "countries/Song.txt"
GUN = "countries/Guang.txt"
CBO = "countries/Bo.txt"
MYI = "countries/Mayi.txt"
WEI = "countries/Wei.txt"
MOG = "countries/Muge.txt"

#Mainland Southeast Asia Nations
#KWB = "countries/Kawsambi.txt"
#SCT = "countries/Sibsongchautai.txt"
#YNK = "countries/Yonok.txt"
#TNA = "countries/Nan.txt"
#RTK = "countries/Rattanakiri.txt"
#CTK = "countries/Chaktomuk.txt"
#SVP = "countries/Sovannaphum.txt"
#PHI = "countries/Phimai.txt"
#CIG = "countries/Chaliang.txt"
#DVR = "countries/Dvaravati.txt"
#TWB = "countries/Thuwannabhu.txt"
#RMD = "countries/Ramandessa.txt"
#KYA = "countries/Kayah.txt"
#SKT = "countries/SriKshetra.txt"
#TKL = "countries/Takola.txt"
#THA = "countries/Thammarat.txt"

#Central Asia Horde
KNM = "countries/Kunmo.txt"
CDT = "countries/Cadota.txt"
KCN = "countries/Kuchana.txt"
SUH = "countries/Shule.txt"
ABZ = "countries/Abrizig.txt"
CKA = "countries/Cackand.txt"
RXL = "countries/Ruxolani.txt"
TKR = "countries/Tokhari.txt"
KYR = "countries/Kyrgyz.txt"
BSM = "countries/Basmyl.txt"
YBQ = "countries/Yabaqu.txt"
TTR = "countries/Tatar.txt"
TGR = "countries/Tegrek.txt"
DHE = "countries/Dahe.txt"
CGA = "countries/Chongan.txt"
HEI = "countries/Cheonli.txt"
HEK = "countries/Heuksubu.txt"
BYL = "countries/Buryeol.txt"
WLH = "countries/Wolhui.txt"
